R 1000 800

NO	./textures/grass.xpm

SO	./textures/stone.xpm

WE	./textures/metal.xpm

EA	./textures/wood.xpm

C 225,30,0

F 63,225,29

S	./textures/brick.xpm

111111111111111111
10000000000000000101
11101100000000011111
11101100000020011111
11101100000000011111
   110000000000011111
11111100000000011111
111111000N0000011111
11111100000000011111
11111111111111111111
