
R 1500 700

NO	./textures/grass.xpm

SO	./textures/stone.xpm

WE	./textures/metal.xpm

EA	./textures/wood.xpm

C 225,30,0

F 63,225,29

S	./textures/brick.xpm

  11111111    11111111
  11100001111110000001111
  11100000000000000111111
  11100000000000000111111
  11100000000000000111111
  11100000000000000111111
  11100000000000000111111
  11110000000000000111111
  1001100000000N000111111
  11110000000000000111111
  11111111111111111111111
