R 1000 800

NO	./textures/grass.xpm

SO	./textures/stone.xpm

WE	./textures/metal.xpm

EA	./textures/wood.xpm

C 225,30,0

F 200,78,6p0

S	./textures/brick.xpm

111111111111111111
11111100000000011111
11111100000000011111
11111100000020011111
11111100000000011111
11111100000000011111
11111100000000011111
111111000N0000011111
11111100000000011111
11111111111111111111
