R	1000 800

NO	./textures/grass.xpm

SO	./textures/stone.xpm

WE	./textures/metal.xpm

EA	./textures/wood.xpm

C 225,30,0

F 200,78,60

S	./textures/brick.xpm

    11 1 1 1111
111111 111 111111
111011110111010111
 1101100000000011111
 1100000000000011111
 1111100000020011111
 1111100000000011111
 1111100000000011111
 1111100000000011111
 11111000N0000000011
 1111100000000011111
11111111111111111111
