
R 1000 800

NO	./textures/grass.xpm

SO	./textures/stone.xpm

WE	./textures/metal.xpm

EA	./textures/wood.xpm

C 225,30,0

F 220,100,0

S	./textures/brick.xpm

  11111111111111111111
11100000000000000001111
11100000000000001111
111000000000110001111
  1000000000110000011
  1000000000000000011
  10001110000000000011
  100011100000000000011
  1000111000000N000011
  1000000000000000001
  1100000000000000011111
   100000000000000011
  0111110002000000011
  1110010000000000111
  1 111111111111111 1
