  1111111
111001111
  10000011
  10000001
  110000011111
   100000000011
  11111000000011
  111000W000011
  1111111111111
