
R 1500 700

NO	./textures/grass.xpm

SO	./textures/stone.xpm

WE	./textures/metal.xpm

EA	./textures/wood.xpm

C 225,30,0

F 63,225,29

S	./textures/brick.xpm

  11111111111111111111
  11100000000111111
  11100000000111111
  11100000000111111
  11100000000111111
  1110000000111111
  11100000000111111
  1 111111111111111 1
